They do not!	The only thing
They do to!	I’
I hope so.	I'm not sure what
She okay?	I mean, she's
Let's go.	I'll take you to
Wow	, I'm so glad
Okay -- you're gonna need	to get a new one
No	, I don't think
I'm kidding.	I'm not going to
Like my fear of wearing	a bra, I have
The "real you".	I have been
What good stuff?	I’
I figured you'd get to	it eventually." "I
Thank God!	I'm glad you're
Me.	I’
What crap?	I'm not a fan
do you listen to this	shit?" "I'm
No.	1: The best player
Then Guillermo says, "If you	're going to be a
You always been this selfish?	I’
But	the most important thing is
Then that's all you had	to do." "You
Well, no.	I don't think so
You never wanted to go	to the movies with me
I was?	I was just trying to
I looked for you back	at the house." "
Tons	of new features and improvements
Have fun tonight?	I'm going
I believe we share an	interest in the subject of
You know Chastity?	She's the one who
Looks like things worked out	for the best. I
Hi.	I'm new to the
Who knows?	I’
So that's the kind of	thing that I'm looking
Lesbian?	Gay? Bisexual?
She's not a.	..."
I'm workin' on it.	I'm workin'
I really, really, really wanna	see this movie. I
Sure have.	I've been to the
Eber's Deep Conditioner every two	weeks. I have been
How do you get your	kids to eat their vegetables
You're sweet.	I'm not."
You have my word.	I will not let you
I counted on you to	be the one to tell
You got something on your	mind?" "I'm
Where?	is
There.	I've got it."
Well, there's someone I think	you should meet." "
How is our little Find	lay girl doing?" "
Forget French.	Forget English. Forget German
That's because it's such a	great idea.
I don't want to know	." "I don't
Right.	I'm not
C'esc ma tete.	_C'
Let me see what I	can do." "I
Gosh, if only we could	have a little more of
That's a shame.	I was hoping to see
Unsolved mystery.	I have a
Why?	The reason is
Seems like she could get	a lot of mileage out
The thing is, Cameron --	and I'm not the
Cameron.	The first thing
No, no, it's my fault	." "I'm sorry
Forget it.	I'm not going to
You're asking me out.	You're asking me out
Okay.	I'm going to go
Not the hacking and gagging	, but the fact that
Well, I thought we'd start	with the basics.
Can we make this quick?	I have a lot of
I did.	I did
You think you ' re	the only one who's
I don't have to be	a genius to know that
I have to be home	by six." "I
All I know is --	I'm not going to
Sometimes I wonder if the	world is really as bad
Bianca, I don't think the	problem is that you are
Combination.	The combination of
Is he oily or dry?	I have a
He practically proposed when he	was in the middle of
Would you mind getting me	a glass of water?"
Great	er ManchesterGreat
Joey.	I’
Who?	is
Where did he go?	I was just
You might wanna think about	this.I
No.	1: The best player
Did you change your hair?	I did.
You know the deal.	You’ve been
Listen, I want to talk	to you about something."
You're concentrating awfully hard considering	you're not even in
Hi, Joey.	I'm a big fan
Hey, sweet cheeks.	I’m back
My agent says I've got	to get a new agent
Neat.	I'm not
It's a gay cruise line,	and it's a gay
Queen Harry?	Queen Elizabeth II
So yeah, I've got the	new job. I'm
Hopefully.	I'm not
Exactly  So, you going	to be able to get
Expensive?	I'm not
It's more	than a little ironic that
Perm?	A:
Patrick -- is that- a.	Patrick -- is
It's just you.	I'm not going to
Is that woman a complete	idiot?I
No!	No! No
What?	I’
I just wanted --	I just wanted to say
You set me up.	"
Let go!	
So did you	get the job?" "
You looked beautiful last night,	and I'm glad you
I guess I'll never know,	but I'm not going
Not all experiences are good,	and some are downright awful
God, you're just like him!	You're just like him
I guess I thought I	was going to be able
I'm not stupid enough to	think that I'm the
That's not	what I meant." "
No.	1: The best player
I wanted to let you	know that I have been
Why didn't you tell me?	I would have helped you
After that, I swore I'd	never go back to the
But	the most important thing is
Just once.	Just once
You did what?	I did what
He said everyone was doing	it, and he was
As in.	The first thing
Now I do.	I'm not
But you hate Joey	." "I don't
He was, like, a total	jerk." "He was
Why?	The reason is
In 9th.	grade, I was a
What?	I’
Joey never told you we	were going to be here
I wish I had that	kind of money." "
I do care.	I care about the people
Like you care.	You care about
Listen, I know you hate	me." "I know
You're welcome.	I'm not
I don't get you.	You're a good man
I really don't think I	can do this." "
Bianca, I need to talk	to you." "I
Can we go now?	I'm tired."
You are so completely unbalanced.	You are so completely un
Yeah, he's your freak friend	." "He's not
It's Shakespeare.	It's the Bard.
Like I'm supposed to know	what that means?" "
At least I'm not a	liar." "I'm
Can't you forget for just	one day?" "I
Bogey Lowenstein's party is normal,	but it's not normal
What's normal?	I'm a
You're ruining my life'	"I'm
I think you're a freak.	I think you're a
What do you think?	I’
Oh, I thought you might	be interested in this."
It means that Gigglepuss is	a very good girl.
Oh my God, does this	mean I have to go
Can you at least start	with the basics?
I have the potential to	be a great writer.
Nowhere.	The first time
Where've you been?	I've been looking for
I have a date, Daddy.	I'm going to be
I'm missing something.	A:
Fine.	I'll be there."
You're not going unless your	mother says so." "
He's not a "hot rod".	He's a "hot
It's that hot rod Joey,	and he's got a
No, but	I'm not going to
The prom?	
Daddy, I want to discuss	something with you." "
Because she'll scare them away.	"I'm
Why?	The reason is
Promise me you won't talk	to anyone about this."
Just for a minute	, I want to tell
Daddy, no!	"I'm
Wear the belly before you	eat the meat.
It's just a party.	It's not a big
Oh, God.	I'm so sorry."
If Kat's not going, you're	not going." "I
Daddy, people expect me to	be a good girl."
It's just a party.	It's not a big
Otherwise known as an orgy?	The term �
If you must know, we	are a family of four
And where're you going?	I'm going
Daddy, I --	I'm sorry." "
Exactly my point	.------
But she doesn't want to	be a mother. She
But it's not fair --	it's not fair to
Then neither will you.	You're not going to
What if she never starts	?" "She's a
No!	No! No
Now don't get upset.	I'm not saying that
Just sent 'em through.	I'll be in
Padua girls.	The first thing
Never	mind the fact that the
Fan of a fan.	Menu
Didn't have you pegged for	a fan of the show
Always a pleasure, Brucie.	I'm glad you're
Best case scenario, you're back	to square one.
You humiliated the woman!	"
No, I ' m not.	I'm not.
Buttholus extremus.	Butthol
The hell is that?	The hell is
Extremely unfortunate maneuver.	I was in
Hell, I've just been going	through the motions." "
You told me that part	of the reason you wanted
It's her favorite band.	She's been listening to
Assail your ears for one	of the most unique and
Okay!	I’m going
He's pretty!	I'm not
Dead at forty-one.	That's what
Her favorite uncle	, who was a doctor
It's a lung cancer issue	." "I'm sorry
Number one.	I’
Are you kidding?	I'm not going to
Will Bogey get bent?	I'm not
In that case, we'll need	to get a new one
This is it.	The last day of the
Like we had a choice?	I’
You got him involved?	"
Hey -- I've gotta have	a word with you."
I thought you hated those	things." "I do
You know, if you do	that, you're going
That's what I just said	." "I'm not
Did she actually say she'd	be willing to do it
Forget his reputation.	Forget his legacy. Forget
I'm serious, man, he's whacked.	He's a fucking nut
They always let felons sit	in the front row."
No kidding.	I'm not sure what
He seems like he thrives	on the attention." "
What makes you think he'll	be there?" "I
You wanna go out with	me?" "I'm
What about him?	"He's
Unlikely, but even so, she	was still a little surprised
I teach her French, get	her to read, and
The mewling, rampalian wretch herself.	"I'm
That's her?	"I'm
Yeah, just a minor encounter	." "I'm fine
You could consecrate with her,	and then you could have
You mean I'd get a	job?" "I'm
Guess who just signed up	for a new job?
Sure do .	.. and I'm
You know French?	I know a
Joey Dorsey?	Joey Dor
He always have that shit-eating	grin on his face."
Because they're bred to.	The first time
Why do girls like that	?" "I don't
I could start with your	name." "I'm
Why not?	I'm not
Bianca Stratford.	The first time
Who is she?	She is a
You burn, you pine, you	die.The
That girl -- I --	I -- I -- I
Yeah, but these guys have	been doing this for a
That I'm used to.	I'm used to being
Couple thousand.	"I'm
How many people go here?	I've been
Get out!	Get out
Thirty-two.	That’
How many people were in	the room when the decision
Yeah.	I'm not sure what
I was kidding.	I
North, actually.	"I'm
So -- which Dakota you	're talking about?" "
C'mon.	You know you want to
So they tell me.	I'm not sure I
You the new guy?	I'm new
You get the girl.	I get the money."
What's the worst?	The worst is
Where?	is
She kissed me.	I kissed her
You makin' any headway?	"I'm
She just needs time to	adjust." "I'm
She hates you with the	fire of a thousand sun
I don ' t know.	I don't know.
What'd you do to her?	I didn't
Then, go get her	." "I'll be
Sure	, I’m
Cameron -- do you like	the idea of a "
She's partial to Joey, not	me." "I'm
What 're you talking about?	I'm talking
It's off.	The first time
Cameron, I'm a little busy	right now." "I
Don't make me do it,	please." "I'm
Gigglepuss is playing there tomorrow	.I'm
So what does that give	you?A
Okay -- Likes:  Thai	food, the beach,
I've retrieved certain pieces of	information from the database,
What've you got for me?	"I'm
Yeah -- we'll see.	------j
And he means that strictly	. He's not going
And why would I do	that?" "Because I
Leave my sister alone.	She's not a bad
Your sister here?	”�
Away.	The first time
Where ya goin?	Main menu
Not at all	." "I'm just
Hey -- do you mind?	I'm trying to read
They're running the rest of	the way." "I
Yeah, and I noticed the	same thing. I think
The vintage look is over,	and the new look is
Enough with the Barbie n'	Ken stuff.
I don't know, Dorsey.	I don't know."
Get her to act like	a lady." "I
Do what?	I’
How'd you do it?	I'm not
A deal's a deal.	That's the
It's about time.	The first time
Forget her sister, then.	She's not worth it
Forget it.	I'm not going to
A hundred bucks a date.	That's what it costs
What?	I’
I just upped my price	to $10.00
I got her under control.	She's a good girl
Watching the bitch trash my	house." "I'm
I'm on it	." "I'm on
When I shell out fifty,	I get a free drink
Fifty, and you've got your	own place." "I
Take it or leave it.	That’
Fine, thirty.	I'm thirty."
I can't take a girl	to a place like this
How much?	
I can't date her sister	." "I'm not
You're gonna pay me to	do what?" "I
You got it, Verona.	I'll be there."
But you'd go out with	me, wouldn't you
You need money to take	care of your family.
You just said	that you were going to
Sure, Sparky.	I know you're a
Yeah, whatever.	I'm not going to
Two legs, nice rack.	I’
What do you think?	I’
Yeah	, I know." "
Hey -- it's all for	the best. I'm
You better not fuck this	up." "I'm
What?	I’
You and Verona?	I don't think so
Uh,  yeah.	I'm not sure
I hear you're helpin' Verona.	I'm glad to hear
So what you need to	do is to create a
Does this conversation have a	point?I
But she can't go out	there. She can't
We're not.	We're just trying to
Well, actually, I thought I'd	try to get a few
We don't chat.	We don't talk.
Nope - just came by	to say hi. I
Are you lost?	Search
Hey.	I'm a newbie
Oh, honey -- tell me	again about the time you
William - he asked me	to give you this."
Who?	is
Have you seen him?	I have been
Oh, good.	I'm glad you're
You ' re looking at	a very good example of
Okay, okay, we won't go.	We'll just go to
Listen to you!	You're a good man
Well, I guess we're not,	but I'm not sure
Can you even imagine?	I can�
I got drunk.	I got drunk and I
You didn't	know that?" "I
I did Bianca a favor	." "I told her
You didn't have a choice?	I'm not
I didn't have a choice.	I had to do it
You went to the party?	I went to
Who cares?	I’
What'd he say?	"I'm
No fear.	I'm not going to
You think this'll work?	You think you can get
If I was Bianca, it	would be a no-
Does it matter?	I’
I appreciate your efforts toward	a better understanding of the
Neither has his heterosexuality.	"I'm
That's never been proven	." "I'm not
William didn't even go to	the funeral. He was
William would never have gone	to the police. He
So he has this huge	, huge, huge,
You could always go with	the "I'm not
The people at this school	are so nice and helpful
But imagine the things he'd	say if he were here
I realize that the men	who are in charge of
An attempted slit.	The first time
What's this?	This blog is
Just a little.	Menu
Mandella, eat.	You're going to need
Block E?	
He always look so	happy, so contented
I'm sure he's completely incapable	of it." "I
That's Pat Verona?	I thought he was dead
Patrick Verona   Random	House, Inc.
Who's that?	Who's that
Don ' t you even	know what you're
Oh, Bianca?	I'm sorry. I
Because I like to torture	myself, I’
Why is my veggie burger	so dry?
Yeah, but then I fucked	up." "I'm
Is that right?	I'm not
Besides, I had some extra	time to kill.
I thought you could use	this to get the current
A Fender Strat.	A Fender
I didn't care about the	money." "I just
Really?	I thought you were a
It wasn't like that.	I was just trying to
You were paid to take	the test." "I
Wait I.	I'm not sure if
It gets worse -- you	can't even use the
That ' s completely adorable!	I love the way you
That's where I was last	night." "I was
What?	I’
My grandmother's .	..I
Look, I'm  -- sorry	." "I'm sorry
Oh huh	?" "I'm sorry
It's just something I had.	I don't know why
It's Scurvy's.	I'm not sure if
How'd you get a tux	?" "I borrowed it
Nothing!	is
Answer the question, Patrick	." "What do you
You need therapy.	You need to get help
You tell me.	I'm not sure."
So I have to have	a new car. I
Create a little drama?	I'm a
Because I don't want to.	I don't want to
Why not?	I'm not
No, I won't go with	you." "I'm
No what?	No, I
No.	1: The best player
You know what I mean	." "I'm not
Is that a request or	a demand?" "I
Go to the prom with	me." "I'm
You're amazingly self-assured.	I'm not sure I
No one else knows	about this." "I
What?	I’
You're sweet.	I'm not."
No -- something real.	------j
I hate peas.	I hate them. I
Tell me something true.	I’
I know the porn career's	not going to last forever
Hearsay.	The term �
The duck?	
Fallacy.	The fallacy of
State trooper?	I'm a
For.	The first thing
You up for it?	I'm not
You never disappointed me.	I always knew you'd
How?	The first step
Then you screwed up	." "You're not
Something like that	.A:
So if you disappoint them	, they will not be
I don't like to do	this, but I'm
Yes	, I know, I
Acting the way we do.	Menu
So what's your excuse?	I'm not
Yeah, well, don't let it	get to you." "
A soft side?	I have a
I dazzled him with my	smile. "I'm
So how'd you get Chapin	to do it?" "
Good call.	I was thinking of the
I figured it had to	be something like that.
The Partridge Family?	The Partridge
Maybe.	I don't know.
You want me to climb	up there?" "I
Forget it.	I'm not going to
Put your right foot there	." "Put your right
Try lookin' at it from	the other side." "
C'mon.	You know you want to
I guess I never told	you about the time I
Look up, sunshine	." "I'm coming
He left!	He left
Other than my upchuck reflex?	I'm a
So what did I have	to do to get a
Don't for one minute think	that I'm not aware
Unwelcome?	I am a
Unwelcome.	That’
Wholesome.	Main menu
Pleasant?	"Ple
You 're so --	" "I'm so
I heard there was a	problem with the new version
What are you doing here?	”�
Excuse me, have you seen	this man?" "No
No offense, but you're sister	's a bit of a
BIANCA	, Italy — The first
Who?	is
He just wants me to	be happy." "I
So what ' s up	with the new look?
I'm gettin' there	." "I'm get
Oh, so now you think	you're a big shot
You don't strike me as	the type who would be
My father wouldn't approve of	this." "He's
Start a band?	I'm a
This.	This is the
Do what?	I’
I should do this.	
Why'd you lie?	I'm not
Then why'd you ask?	I don't
No, you weren't	." "I was."
Maybe.	I don't know.
Were you in jail?	I was in
Busy	box is a small,
When you were gone last	night, I was thinking
But it's Gigglepuss - I	'm not sure if that
And I'm in control of	my own destiny." "
What?	I’
Kat!	is
You know what they say	about the best laid plans
I thought you were above	this." "I am
Hey man.	I'm a newbie
I know.	I know
I hate him.	I
Dorsey.	The first thing
Who?	is
Why'd you let him get	away?" "I didn
Just let me sit down.	I'm going to be
See that?	That's the kind of
Like you could find one	of those in the back
Because then I'd have to	go back to the beginning
Why?	The reason is
Sure, I do	. I'm a big
You don't care if I	'm a man or a
I told you	I'd be back."
Why 're you doing this?	I'm doing
Leave it to you to	find a way to make
This is so patronizing.	I'm not a child
What if you have a	friend who is a little
I know, just let me	finish." "I'm
Uh, uh.	I'm not going to
I just need to lie	down." "I'm
You're not okay.	
I'm fine.	"
Okay?	I’
Funny, you're the only one	who's ever said that
I say, do what you	want. I'm not
"I'm getting trashed, man.	I'm getting trashed
What's this?	This blog is
Why, don't you?	I'm not
You know who The Raincoats	are, right? They
You know, these guys are	really good." "They
Do you mind?	I'm trying to read
That's what you want, isn't	it?" "I want
Excuse me?	I’
hey.	I'm not
Depends on the topic.	I'm not
You're not a big talker,	are you?" "No
Hi	everyone,I
I was in the laundromat.	I was washing my clothes
Are you following me?	I’
Seven-thirty?	I'm not sure.
You -- covered in my	blood." "I'm
Come on -- the ponies,	the ponies, the ponies
And why would I do	that?" "Because I
Then say you'll spend Dollar	Day with me." "
I don't really think you	can say that. I
You hate me don't you?	You hate me for what
I know a lot more	about the history of the
Like where?	"Where?"
The night I take you	to the movies, you
Oh, right.	I forgot. You're
Pick you up Friday, then	?" "Yeah." "
My mission in life.	Menu
There's a way to get	the most out of your
Sweating like a pig, actually.	I’
I mean Wo-man.	I mean Wo
Oh, Christ.	I'm sorry. I
When I go?	I’
You know, fathers don't like	to be called 'd
No -- impressed.	I'm not
What's the matter?	You look like you've
Bianca did what?	"I did
The part where Bianca beat	up the guy who was
Which parts?	The first part
Parts of it.	I’
So tell me about this	new job." "I
No, Daddy.	I'm not going to
I don't understand the allure	of the "I'm
Funny.	I was just thinking about
Yeah.	I'm not sure what
Was that your sister?	I don't
I want to go to	the beach." "I
You're eighteen.	You're a man.
So what I want doesn't	seem to be possible.
As a parent, that's my	job. I'm not
Because you're making decisions for	me." "I'm
Why can't we agree on	the definition of a "
I thought you were punishing	me." "I'm
Is this about Sarah Lawrence?	I’
Then tell them I had	to go to the bathroom
My insurance does not cover	this. I have to
Enough!	I'm not going to
This from someone whose diary	is full of references to
You decided.	You're going to do
I thought we decided you	were going to be a
I know.	I know
Just smack her now.	"I'm
Am I supposed to feel	sorry for you?" "
No .	.. no, I
Tempestuous?	I have been
The point is Kat --	you can't just say
I still maintain that he	is the best player in
Well, yes, compared to your	average American, I am
Expressing my opinion is not	a crime.
Katarina Stratford.	Photo: Getty Images
Yeah.	I'm not sure what
Kat a fan, too?	I'm a
Right.	I'm not
Macbeth, right?	I’
Oh yeah.	I'm not sure if
You think?	I don't know.
Yeah.	I'm not sure what
Cool pictures.	Menu
Hi.	I'm new to the
Hey there.	I'm a newbie
Man -- don't say shit	like that." "I
Sweet love, renew thy force!	_Enter_
You were right.	I was wrong. I
No - I've got a	few things to do first
So you got cozy with	the new year and now
I'm likin' you guys better	than I did before."
I prefer to think of	it as a "t
Yeah.	I'm not sure what
Ever been to Club Skunk?	I've been
Just for now.	A:
Are you telling me I'm	not allowed to have a
Good enough.	I'm not
What?	I’
We're your guys.	We're your family.
You two are gonna help	me get the money."
Patrick, Pat, you're not looking	too good." "I
So Dorsey can get the	ball rolling on the next
That's where we can help	. We can help you
Dorsey can plow whoever he	wants. He's a
I think I speak correctly	. I am a native
What is it with this	country and its obsession with
The situation is, my man	, that you are a
What plan?	I have a
Whatever the hell it is	, it's not a
What?	I’
Say it	ain't so, Joe
See you next week!	The following is
You're completely demented.	You're a fucking lun
Well, you know -- there's	a lot of things that
You weren't abused, you aren't	a victim, you are
What's to discuss?	You're a man,
Why don't we discuss your	case?" "I'm
I'm at a loss, then.	I don't know what
Touch of the flu.	I’
I don't understand, Patrick.	I don't understand why
With the teeth of your	opponent, you can use
It was a bratwurst.	It was a
It says here you exposed	yourself to the sun."
I missed you.	I missed you so much
That ' s what I	'm saying." "
Absolutely not.	I'm not going to
Did I have anything to	do with it?" "
Your daughters went to the	beach?" "Yes."
What just happened?	Your web browser
But -- who -- what	-- who -- who --
Have a great time, honey!	I'm so
Dr.	John W. Miller,
What do you wanna watch?	I'm a
Kissing?	I'm a
They'll dance, they'll kiss, they'll	make love, they'll
Pirate -- no question.	I'm not
Would you rather be ravished	by a man or a
You're not helping.	I'm not
Tumescent!	Tumescent
Jesus!	I'm so sorry."
Sarah Lawrence is on the	verge of a career breakthrough
What's a synonym for throbbing?	A:
Make anyone cry today?	I'm not
In the microwave.	In the microwave
Can't be that far, I	'm sure." "I
We left three weeks ago,	and I'm still not
We should have seen land.	We should have seen land
We'll all go crazy.	We'll all go crazy
He's the devil's child.	He's the devil's
With a face like that?	I'd be afraid to
Ah, leave him alone.	He's just a kid
What are you listening to,	my dear?" "I
You'll be drinking your own	blood." "You'll
The water's going putrid in	here." "I'm
I never seen heat like	this." "I'm
IF-GOD-WILLS-IT!	I’
Asia can be found to	be a very important part
Blind faith is what I	call it. It�
Don't you realize your words	are killing me?" "
Did He not choose a	virgin for you,
If God intended our proximity	to each other, he
No.	1: The best player
Is that all that interests	you?" "I'm
Trade, Your Excellency.	The first thing
If they agree to follow	the rules, they can
Your life, and that of	your family, is in
Your Eminence, there is only	one thing I can say
Excellency, you are right.	I am a fool.
Senor Colon, an experienced captain	, was a man of
Then you cannot ignore that	the majority of the people
I am, Your Eminence	,Your humble
Unfortunately, Don Colon, that is	not the case.
Yes, your Eminence.	I am a priest of
You say Asia can be	a great place to live
A waste.	
What a tragedy.	I was just
You can see for yourself.	The first thing
On the contrary, Your Eminence.	I have been told that
It won't be easy to	get a job in the
Indeed.	I'm not sure if
He is a mercenary!	
Naturally.	I'm a man of
The Judgment is ours!	The Judgment is
The State has some reason	to believe that the defendant
I can't keep my eyes	open." "I'm
What is it, now?	I’
I am busy inside.	I am busy outside.
Can't you stay with us	?" "I'm not
Not everything.	I’
They took everything.	They took my life.
They tried.	They failed. They tried
God.	I’
I can arrange for the	car to be ready for
You don't usually ask.	You just do it."
Beatrix, I want to ask	you something." "I
That's something you can't decide.	You can't decide if
I don't want you to	be afraid of me."
I'm not asking you to	do anything." "I
Thank God.	I'm so glad you
She said yes.	"I'm
I find that hard to	believe. I mean,
Perhaps I was never meant	to be a writer.
I'd love to argue with	you, but I'm
Are we going to argue?	I’
Well.	I'm not sure if
I haven't given you much	of a chance to get
I know.	I know
I could be gone for	a while." "I
I am afraid this is	a bit of a long
How could I be?	I'm not a murderer
I am not a seaman.	I am not a sailor
How far from here?	How far from
Congratulations.	You’ve made
Viceroy of the West Indies.	The Vicer
Appointment to what?	The appointment of
My letters of appointment.	I have been
Yes.	I'm sure it's
Don Alonso de Bobadilla.	The first of
Bartolome and Giacomo Colon.	The Colon family
May I ask by whom?	A:
Forgive me, Don Bobadilla --	I'm not sure I
I understand that you will	be in the office on
Tell me the first thing	that comes to your mind
Really?	I thought you were a
I want you to tell	me what you think of
He never had one.	He never had a chance
He asks when he can	go home.
What does he say?	"I'm
I am not listening, Father.	I am not listening.
What are you listening to?	I’
There must be a passage	in the Bible that says
Father.	The Father.
Not bad.	I'm not sure if
How are you feeling, Fernando?	”�
This time with me!	Menu
I have to explore the	world of the internet.
Yes.	I'm sure it's
Do you swear on all	that is holy that you
You promise?	"I promise
There'll be a time.	When you're ready."
I want to go with	you." "I want
All of them created by	the same person, and
Roofs.	com is a roofing
What do you see?	I see a
Look out of that window.	Look at the sky.
I am not afraid of	death. I just don
Call them.	They're not going to
All I have to do	is to make sure that
To rise so high, in	the midst of so many
What.	I’
You seem to have a	lot of experience with this
Good!	I'm glad you're
Don Bobadilla is already a	legend in the world of
But we do have a	few things to say about
for a commoner?	I'm a
You defend yourself admirably.	I am not surprised.
Forgive me, Don Colon.	I am not a man
They don't see sin in	the same way that we
If you won't accept our	terms, you can't
And were you never ambitious,	my dear?"
Then you are too ambitious.	You are trying to do
I'm not bargaining!	
I remind you, Senor Colon,	that you are a guest
NO.	5-00-0
No?	I'm not
No.	1: The best player
You never learned how to	be a man." "
Utapan, won't you speak to	me?" "I'm
You did the same to	me." "I'm
You have to find them,	and you have to kill
Ask him if he will	be able to get the
He understands.	He's a good man
We will work with his	family to make sure he
He has medicine.	He has a lot of
Chief says.	"I'm
and also to bring medicine.	The first thing
Chief says -- he has	no idea what happened to
To bring the word of	God to the people,
Why?	The reason is
Thousands.	That’
Chief says -- how many?	The chief says
Tell him his country is	at war." "He
Chief knows.	He's been in the
Tell the Chief we thank	him for his time."
You come!	I'll be waiting for
Island.	The island is
What is it?	The new version
Say not here!	"Say not
I don't know.	
Oh?	I thought you were a
New worlds create new people.	Menu
I knew you would.	"
I have to disagree.	I think that the only
You'll always be older than	me." "I'm
I suppose we're both old	enough to know better."
Give me absolution.	I have sinned.
I believed in you.	
You are bound by an	oath to protect the people
My son, my son.	I have been waiting for
If I tell them, they	'll kill me." "
May God forgive you.	I am not
I am not sure.	I think it is a
How long?	
I lied.	I didn't want to
What are you saying?	That I'm a liar
Father, I have betrayed my	people." "I have
I am listening, my son.	I am listening."
Forgive me, Father.	I have sinned."
In Nomine Patris et Filius,	et Spiritus Sancti
Colon!	
All of them!	I’
Damn all of you!	I'm not going to
Colon!	
Damn God!	I'm so sorry."
If God intends you to	be happy, He will
Wait!	Before you go, I
You mustn't give way to	your feelings, you know
Only God knows the meaning	of the word "love
I've been contradicted all my	life. I've been
You get so carried away	with the idea of being
Passion is something one cannot	buy. It is something
Father Marchena!	Father Marchen
I'll try to remember that,	but I'm not sure
Two minutes.	That’s all
So was Christ!	The following is
Esdras is a Jew.	He is a Jew.
The calculations of Toscanelli Marin	etti, the Italian mathematician
How can you be so	sure?" "I'm
Ignorance!	I have been
How can you be so	sure?" "I'm
To open a new route	, you need to create
Why do you wish to	know?""
With some difficulty.	I’
How did you manage it?	I was in
That's what it says.	"I'm
God.	I’
Father, I am doing what	I can to help you
Diego is a bright boy	, but he is not
Your Majesty -- some men	are born to be kings
There is one thing I'd	like to see in the
Thank you.	A:
But without your brothers.	Without your sisters. Without
They come and go as	they please, and they
Do they have such thoughts?	I have a
Thirty seven, Your Majesty.	I am a widow."
How old are you, Senor	?" "I'm not
A woman?	"I'm
I know what I see.	I know what I hear
You show no inclination to	do so.
May I speak freely?	”�
Surely you can do anything	you set your mind to
I cannot ignore the verdict	of the people. I
That she was impregnable.	"I'm
What did they say about	me?" "They said
The ocean is uncrossable?	The ocean is
No more than the woman	who has a child,
I should not even be	here." "I'm
You will regret this.	I’
You'll be held in detention,	and you'll be charged
Savagery is what monkeys understand.	The first time
In one act of brutality,	the police killed a young
You did not hear me,	I said, "I
Don Moxica -- we all	know him as the guy
My horse doesn't work.	I'm not sure why
We can't raise the wheel	." "We can't
We came here to stay!	We came here
We don't need to know.	We don't need to
You want a war?	I'll give you a
If you want to keep	your data safe, you
We lost cousins, friends.	We lost our way.
The Indians have no such	thing as a “
And you say this is	the best you can do
We can't be.	We're not."
He's drawing an isthmus.	He's drawing a line
What's he doing?	He's just
Twenty eight.	That’
What do you read?	Menu
Come over here.	I want to show you
Well, I surely know what	you mean. I've
And what do you think	of the new one?"
Well.	I'm not sure if
God be with us admiral.	I'm not
Due west, Captain Mendez.	We'll be there in
You're right.	I'm not a good
You tell that to them!	I’
Pinzon, Pinzon.	Pizarro
You bloody.	You bloody
You never did.	"
Jesus Maria!	"Jesus Maria
And then what?	The answer is
You don't know anything!	You're just a kid
The land is there.	The people are there.
We're lost!	"
You think I don't know	what you're doing?"
We're on the verge of	a new era in the
We have to keep the	pressure on the government to
You must be mad.	You can't possibly think
Six days ago, yes.	I was in the middle
You lied!	You lied to me!
Immediately.	The first thing
Where can I meet this	woman?" "I don
Because he is not afraid	of the truth, he
Then why?	A:
I know, I should not	have said that. I
And who would you think	would be the most likely
He must be replaced.	The only way
Then, what do you suggest,	that I should go to
Is this true, Brother Buyl?	”�
But there is worse.	The worst.
We weren't expecting immediate profits,	but we were expecting to
Every ship returns with a	story. The USS Cole
Yes.	I'm sure it's
Into a monk.	"I am
Never, Your Majesty.	I am not a man
You were right, Don Sanchez.	I was wrong."
Yes, Your Majesty.	I am ready to serve
Is that the man I	saw in the park?"
Officers, there's your killer, do	you see him?" "
so we kill someone famous	, we get a lot
I don't think it's abuse,	but I do think it
I'm abused.	I
Can I see your back?	”�
Out on my back when	I was a kid,
Your father put cigarettes out	on the table." "
That's what he did to	me." "He's
Yeah, he hated me from	the start." "He
Your father blamed you for	the death of his wife
Yeah, yeah.	I know. I know
Back in the Czech Republic?	I'm a
Yeah, she went blind giving	birth to me." "
Your mother was blind?	I was just
My father always degraded me.	He was a very cruel
Tell me about yourself.	I’
Give me another one, please.	I’
I need to know about	the new version of the
What else do you need?	I'm not
This is not about money,	it's about the right
Thirty-percent.	That’s the
But it's.	It's not. It
No.	1: The best player
I would say.	I would say
What's your cut?	The cut of
Look, I haven't really focused	on the whole "I
What about my movie rights?	I’
Don't worry about him.	He's just a little
No, he is here.	He is here. He
Disappeared.	The word was
What about Oleg?	"Oleg
Well, you didn't appreciate the	fact that I was trying
I was all of these.	I was a little girl
delusions and paranoia.	The first thing
Oh, sure.	I'm sure. I
You bring the cigarettes?	I'll bring the beer
I brought you some letters.	I thought you might like
I'm invoking rights - this	is a violation of the
Yes.	I'm sure it's
I'm coming with you.	I'm coming with you
Where are we going?	Where are we
Don't say anything.	Just listen."
He has the camera!	The camera is
Emil.	The first thing
Oh no!	Where's the JavaScript?
Here.	I'll do it."
I'm not your lawyer until	I've had a chance
Are you my attorney?	I am a
Daphne, I.	N. M
I don't want to drag	you into this." "
Do you really want me	to do this?" "
Forget about me.	I'm not the one
Pouring it out!	Menu
What are you doing?	I'm trying
I'll get my clothes.	I'll be right back
I'll make some for us.	I'll make some for
In the kitchen.	Menu
Do you have coffee?	I’
Right.	I'm not
